NO textures/north.png
SO textures/south.png
WE textures/west.png
EA textures/east.png

C 252,15,192
F 1,1,255

        1111111111111111111111111
        100000000011001110000000111111111111111111111111
        100000000111000000000000000000000000000000000001
        100000000000000000000000000000000000000000000001
11111111101100000111000000000000111111111111111111111111
100000000011000000000111111111111
111111111111111001000000100011111
        1000000000110011100000001
        1000000001110000000000001
        1000000000000000000000001
111111111011000001110000000000001
100000000011000001110111111111111
11110000001111111100000010001 
11110000001011011101010010001
11000000001111011100000010001
10000000000000001100010010011                                     
10000000000000001100000010011
11000001110101011111011110000
1111011111110101 101111000011
11110111 1111111 111111110111
11110111111011011101010010001
11000000111111011100000010001
10000000000000001100010010011                                     
10000000000000000100000010011
110000011101010111110111100011
11111S11111110101 101111000001
11111111 11111111 111111111111