NO textures/north.png
SO textures/south.png
WE textures/west.png
EA textures/east.png

C 1,1,1
F 255,255,0

        1111111111111111111111111
        1000000000110011100000001
        1000000001110000000000001
        1000000000000000000000001
111111111011000001110000000000001
100000000011000001110111111111111
11110111111111111100000010001 
11110111111011011101010010001
11000000111111011100000010001
10000000000000001100010010011                                     
10000000000000001100000010011
110000011101010111110111100011
11111011111110101 101111000001
11111111 1111111 1111111111111
        1111111111111111111111111
        1000000000110011100000001
        1000000001110000000000001
        1000000000000000000000001
111111111011000001110000000000001
100000000011000001110111111111111
11110111111111111100000010001 
11110111111011011101010010001
11000000111111011100000010001
10000000000000001100010010011                                     
10000000000000001100000010011
110000011101000111110111100011
11111011111110101 101111000001
11111111 1111011 1111111111111
        1111101111111111111111111
        1000000000110011100000001
        1000000001110000000000001
        1000000000000000000000001
111111111011000001110000000000001
100000000011000001110111111111111
11110111111111111100000010001 
11110111111011011101010010001
11000000111111011100000010001
10000000000000001100010010011                                     
10000000000000001100000010011
110000011101010111110111100011
11111011111110101 101111000001
11111111 1111011 1111111111111
        1111101111111111111111111
        1000000000110011100000001
        1000000001110000000000001
        1000000000000000000000001
111111111011000001110000000000001
100000000011000001110111111111111
11110111111111111100000010001 
11110111111011011101010010001
11000000111111011100000010001
10000000000000001100010010011                                     
10000000000000001100000010011
110000011101010111110111100011
11111011111110101 101111000001
11111111 1111011 1111111111111
        1111101111111111111111111
        1000000000110011100000001
        1000000001110000000000001
        10000000000000000S0000001
111111111011000001110000000000001
100000000011000001110111111111111
11110111111111111100000010001 
11110111111011011101010010001
11000000111111011100000010001
10000000000000001100010010011                                     
10000000000000001100000010011
110000011101010111110111100011
11111011111110101 101111000001
11111111 1111111 1111111111111
        1111111111111111111111111
        1000000000110011100000001
        1000000001110000000000001
        1000000000000000000000001
111111111011000001110000000000001
100000000011000001110111111111111
11110111111111111100000010001 
11110111111011011101010010001
11000000111111011100000010001
10000000000000001100010010011                                     
10000000000000001100000010011
110000011101010111110111100011
11111011111110101 101111000001
11111111 1111111 1111111111111